1111111111111
1P01000000C01
1000011111001
100011EC00001
1111111111111
