111111111111111111111111111111
100000000000000000000000000001
100000000C00000000000000000001
100000000000000000000C00000001
1000000000000000C0000000000001
100000000000000000000000000001
100000000P00000000000000000001
100000000000000000000000000001
1000000C0000000000000000000001
100000000000000000000000000001
1000000000000000C0000000000001
1000000000000000000000000E0001
100000000000000000000000000001
100000000000000000000000000001
111111111111111111111111111111
