# Esto es un comentario, el parser debería ignorarlo (o no, según implementación)

NO ./textures/north.xpm
SO ./textures/south.xpm
WE ./textures/west.xpm
EA ./textures/east.xpm

F 220,100,0
C 0,150,220

1111111111
1000100001
10N0100001
1000000001
1111111111